20
OXXXXXXXXXXXXXXXXXXX
              X    X
 XX X  XX XX   X XX 
XX       XX  X  XX X
    XX  XXXXX       
   X X  XXXX X  X X 
    XXX   X    XXXXX
 XXX XX  XX   XX XX 
 XXX      X X  X    
 X    X  XXXXXX    X
 X X   XX X   XXXXX 
XX XX  XX X  X   X X
   XXXXXXX XXXXX XX 
    XXX    XX XX XX 
X   XX  XX  XXX XXXX
 X       X XX  XXX X
 X XX  XX X   XXXXX 
     X XX  X XX X   
                    
XXXXXXXXXXXXXXXXXXCX
